1111111111
101C111111
1010000011
1011111P01
1C00000001
1010C00001
1010010001
1001110001
1001111101
1C000000E1
1111111111
