1111111111
10XCXXXXX1
10X0000011
10XXXXX001
1C00000P01
1000C00001
10000X0001
100X0X0001
100XEX0001
1000000001
1111111111
